Month,Revenue,Expenses,Profit,Customers,Orders
January,45000,32000,13000,1200,890
February,52000,35000,17000,1350,1020
March,48000,33000,15000,1280,950
April,58000,38000,20000,1450,1180
May,65000,41000,24000,1580,1320
June,72000,44000,28000,1680,1450
July,78000,47000,31000,1750,1580
August,82000,49000,33000,1820,1650
September,75000,46000,29000,1700,1520
October,68000,43000,25000,1620,1380
November,85000,52000,33000,1900,1720
December,95000,58000,37000,2100,1980 